1       25 1 0 ENBN BRONNOY
100   29.87   1   0 0.00 0 3 0 04   65.45406100  012.20368600  117.96    0.00 2 10 0 0 22   65.46410800  012.22325000  117.96    0.00 2 10 0 0
21   65.45509384  012.20482197  1  38.77   3.00 04  VASI
21   65.46309329  012.22227671  1 218.79   3.00 22  VASI
110   1 0.00   0.00 Apron
111  65.46180751  012.21835233 
112  65.46180751  012.21835233  65.46177421  012.21812255   1 
111  65.46194573  012.21772645   1 
111  65.46214972  012.21768363   1 
111  65.46252607  012.21655377   1 
111  65.46166658  012.21490709   1 
111  65.46155306  012.21519623   1 
111  65.46135155  012.21481457   1 
111  65.46127629  012.21504236   1 
111  65.46060340  012.21374203   1 
112  65.46043930  012.21324776  65.46043153  012.21299715   1 
111  65.46056163  012.21268480   1 
111  65.46082766  012.21183943   1 
111  65.46094748  012.21163609   1 
111  65.46112094  012.21194233   1 
111  65.46132360  012.21125723   1 
111  65.46031151  012.20933583   1 
111  65.46021531  012.20964269   1 
111  65.45918200  012.20753864   1 
111  65.45895370  012.20811147   1 
111  65.45862752  012.20813532   1 
111  65.45842087  012.20873600   1 
111  65.45842753  012.20952257   1 
111  65.45808186  012.21058591   1 
112  65.45788410  012.21071248  65.45776550  012.21058741 
113  65.45788410  012.21071248   1 
111  65.45816572  012.21123961 
112  65.45816572  012.21123961  65.45811939  012.21094132   1 
111  65.45821268  012.21073147   1 
111  65.45849223  012.20991584   1 
112  65.45867009  012.20974041  65.45878869  012.20982513 
111  65.45867009  012.20974041   1 
111  65.45933259  012.21101605 
112  65.45933259  012.21101605  65.45940401  012.21121048   1 
112  65.45941141  012.21179903  65.45946174  012.21203633 
111  65.45941141  012.21179903 
112  65.45941141  012.21179903  65.45947066  012.21212969   1 
112  65.46011059  012.21334718  65.46009191  012.21364988 
111  65.46011059  012.21334718 
112  65.46011059  012.21334718  65.46012457  012.21355128   1 
111  65.46008016  012.21367150   1 
111  65.45992602  012.21410713   1 
112  65.45973736  012.21430277  65.45961831  012.21423532 
113  65.45973736  012.21430277   1 
111  65.46107367  012.21568788 
112  65.46107367  012.21568788  65.46104824  012.21585791   1 
111  65.46117376  012.21599211   1 
111  65.46114434  012.21609516   1 
111  65.46120409  012.21623313 
112  65.46120409  012.21623313  65.46131346  012.21617387   1 
112  65.46138852  012.21644496  65.46139417  012.21660818 
111  65.46138852  012.21644496   1 
112  65.46114317  012.21703669  65.46099911  012.21700949 
111  65.46114317  012.21703669   1 
111  65.46001651  012.21482590   1 
112  65.45999028  012.21443810  65.46004557  012.21419422 
111  65.45999028  012.21443810   1 
111  65.46022073  012.21379488   1 
112  65.46038988  012.21376617  65.46048902  012.21396020 
111  65.46038988  012.21376617   1 
113  65.46117537  012.21535166   1 
112  65.46160130  012.21792792  65.46149679  012.21779190 
111  65.46160130  012.21792792   1 
111  65.46134456  012.21741381 
112  65.46134456  012.21741381  65.46133891  012.21720978   1 
112  65.46154038  012.21677618  65.46161299  012.21674139   1 
111  65.46170093  012.21692599   1 
112  65.46184104  012.21742162  65.46181561  012.21763925 
113  65.46184104  012.21742162   1 
112  65.46018886  012.21292111  65.46006980  012.21283118 
111  65.46018886  012.21292111   1 
111  65.45971137  012.21195256   1 
112  65.45963145  012.21149391  65.45967697  012.21119041 
111  65.45963145  012.21149391 
112  65.45963145  012.21149391  65.45967931  012.21122413   1 
111  65.45980762  012.21138224   1 
113  65.46041785  012.21259425   1 
130 Airport Boundary 6
111  65.46523837  012.21891680 
111  65.45940242  012.20581221 
111  65.45400939  012.19947937 
111  65.45283699  012.20581221 
111  65.46359701  012.22619016 
113  65.46484757  012.22330590 
120 Linear Feature 43
111  65.45909562  012.20977511   1 101 
115  65.45930206  012.20913411 
120 Linear Feature 42
111  65.45941987  012.21037953   1 101 
115  65.45962425  012.20975653 
120 Linear Feature 41
111  65.45966477  012.21114072   1 101 
112  65.45973036  012.21104318  65.45976895  012.21094564 
111  65.45973036  012.21104318   1 101 
115  65.45995030  012.21039753 
120 Linear Feature 39
111  65.46128820  012.21709482   1 101 
112  65.46115466  012.21726175  65.46105965  012.21730503   1 101 
115  65.46097234  012.21714428 
120 Linear Feature 38
111  65.46149619  012.21614267   1 101 
112  65.46151160  012.21636525  65.46150903  012.21650746   1 101 
115  65.46148849  012.21652600 
120 Linear Feature 37
111  65.46177057  012.21796839   1 101 
112  65.46161432  012.21817680  65.46154242  012.21818298   1 101 
111  65.46147629  012.21812426   1 101 
111  65.46127792  012.21773782   1 101 
112  65.46124711  012.21742250  65.46124968  012.21717519   1 101 
111  65.46128820  012.21709482   1 101 
111  65.46140632  012.21675477   1 101 
112  65.46152444  012.21648273  65.46157066  012.21642708   1 101 
115  65.46165027  012.21645799 
120 Linear Feature 36
111  65.45987728  012.21449343   1 101 
112  65.45976879  012.21454765  65.45970088  012.21455276   1 101 
115  65.45960325  012.21447611 
120 Linear Feature 35
111  65.46014434  012.21305908   1 101 
112  65.46020474  012.21335738  65.46021322  012.21347248   1 101 
115  65.46020409  012.21363913 
120 Linear Feature 34
111  65.46037622  012.21351790   1 101 
112  65.46027952  012.21349144  65.46022559  012.21352235   1 101 
111  65.45987728  012.21449343   1 101 
112  65.45987789  012.21477325  65.45988428  012.21492164   1 101 
115  65.45993908  012.21513465 
120 Linear Feature 33
111  65.45809685  012.21079817   1 101 
112  65.45807384  012.21131979  65.45808927  012.21157061   1 101 
115  65.45818889  012.21171952 
120 Linear Feature 32
111  65.45952130  012.21179550   1 101 
112  65.45942524  012.21098153  65.45937730  012.21086549   1 101 
112  65.45867285  012.20948855  65.45862616  012.20940680   1 101 
115  65.45853785  012.20947045 
120 Linear Feature 31
111  65.46174537  012.21864822   1 101 
112  65.46170021  012.21837503  65.46169846  012.21818077   1 101 
111  65.46177057  012.21796839   1 101 
111  65.46192593  012.21749708   1 101 
112  65.46196011  012.21716272  65.46195134  012.21698958   1 101 
111  65.46186068  012.21681630   1 101 
111  65.46164939  012.21644972   1 101 
111  65.46149619  012.21614267   1 101 
112  65.46138544  012.21555636  65.46135785  012.21544394   1 101 
111  65.46130761  012.21536496   1 101 
111  65.46037622  012.21351790 
112  65.46037622  012.21351790  65.46031256  012.21335950   1 101 
111  65.46037130  012.21298546   1 101 
111  65.46065536  012.21212454   1 101 
112  65.46068935  012.21152155  65.46057437  012.21125806   1 101 
112  65.46044055  012.21165562  65.46041190  012.21190854   1 101 
112  65.46058632  012.21233404  65.46053784  012.21260139 
111  65.46058632  012.21233404   1 101 
111  65.46037130  012.21298546   1 101 
112  65.46014434  012.21305908  65.46007489  012.21292216 
111  65.46014434  012.21305908   1 101 
112  65.45952130  012.21179550  65.45950644  012.21160134 
111  65.45952130  012.21179550 
112  65.45952130  012.21179550  65.45947854  012.21143659   1 101 
111  65.45966477  012.21114072 
112  65.45966477  012.21114072  65.45961838  012.21120703   1 101 
112  65.45939943  012.21084366  65.45938168  012.21056080 
111  65.45939943  012.21084366 
112  65.45939943  012.21084366  65.45937203  012.21061884   1 101 
111  65.45941987  012.21037953   1 101 
112  65.45925789  012.21049881  65.45914735  012.21051646   1 101 
112  65.45907515  012.21008215  65.45907052  012.20988938   1 101 
111  65.45909562  012.20977511   1 101 
112  65.45895255  012.20991564  65.45884432  012.20992586 
111  65.45895255  012.20991564 
112  65.45895255  012.20991564  65.45884219  012.20992075   1 101 
112  65.45881537  012.20950949  65.45881613  012.20925662 
111  65.45881537  012.20950949 
112  65.45881537  012.20950949  65.45880340  012.20925662   1 101 
112  65.45892938  012.20874968  65.45892248  012.20855993   1 101 
112  65.45878089  012.20842909  65.45869903  012.20841692   1 101 
112  65.45855997  012.20895898  65.45854454  012.20904724 
111  65.45855997  012.20895898 
112  65.45855997  012.20895898  65.45854647  012.20906117   1 101 
112  65.45853785  012.20947045  65.45851875  012.20956753   1 101 
111  65.45809792  012.21080162   1 101 
112  65.45790256  012.21095630  65.45781130  012.21095119   1 101 
115  65.45771172  012.21080085 
120 Linear Feature 30
111  65.45834111  012.21035474   4 104 
115  65.45823066  012.21012953 
120 Linear Feature 29
111  65.46006275  012.21422946   4 104 
115  65.45996312  012.21402805 
120 Linear Feature 28
111  65.46054511  012.21363400   5 103 
115  65.46045733  012.21390098 
120 Linear Feature 27
111  65.46109386  012.21470097   5 103 
115  65.46099628  012.21499774 
120 Linear Feature 26
111  65.46180003  012.21759026   4 104 
115  65.46190877  012.21780986 
120 Linear Feature 25
111  65.46134110  012.21667981   4 104 
115  65.46145253  012.21690701 
14   65.46083944  012.21317681   82 0 Tower
15   65.45995030  012.21039753 310.00 Stand 11
15   65.45962425  012.20975653 310.00 Stand 12
15   65.45930206  012.20913411 310.00 Stand 13
15   65.45891670  012.20856457 310.00 Stand 14
18   65.45697893  012.21426729 1 BCN
19   65.45500899  012.20666585 1 WS
19   65.46312856  012.21990375 1 WS
54 11960 AFIS
